+++++        +++++
+   +        +0  +
+   ++++++++++  B+
+      Aa        +
+   +++++++++    +
+   +       +b   +
+++++       ++++++
