++++++++
+0+  cb+
+ A+ ad+
+ +++ef+
+ +B+  +
+  DC+  +
+ ++++ + 
+      +
+  +++++
+EF+++++
++++++++