+++++++++++++++++++
+0             B b+
+              ++++
+                 +
+1             ++A+
+               +a+
+++++++++++++++++++
