+++++++++++++++++++
+                 +
+0AAAAAAAAAAAAAAAa+
+                 +
+++++++++++++++++++
