++++++++++++++++++++++++++++
+                 bbbbbbbb +
+0 AAAAAAAAAAAAAAABBBBBBBB +
+  aaaaaaaaaaaaaaa       Cc+
++++++++++++++++++++++++ Cc+
+                        Cc+
+DDDDDDDDDDDDDDDDDDDDDDDD  +
+dddddddddddddddddddddddd  +
++++++++++++++++++++++++++++
