++++++++++++++++++++++++++++++++++++++++++++++++++++++++++++++++++++
+                                                                  +
+                                                                  +
+                                                                  +
+                                                                  +
+                                                                  +
+                                                    a             +
+                                                                  +
+                                                                  +
+                                                                  +
+                                                                  +
+                                                                  +
+                                                                  +
+                                                                  +
+                                                                  +
+              b                                                   +
+                                                                  +
+                                                                  +
+                                                                  +
+                                                                  +
+                                                                  +
+                                                                  +
+                                                                  +
+                                                                  +
+                                                                  +
+                       0                                          +
+                                                                  +
+                                                                  +
+                                                                  +
+                                                                  +
+                                                                  +
+                                                                  +
+                                                                  +
+                                                                  +
+                                                                  +
+                                                                  +
+                                                                  +
+                                                                  +
+                                                                  +
+                                                                  +
+                                                                  +
+        B                                                         +
+                                                                  +
+                                                                  +
+                                                                  +
+                                                                  +
+                                                                  +
+                                                        A         +
+                                                                  +
+                                                                  +
+                                                                  +
++++++++++++++++++++++++++++++++++++++++++++++++++++++++++++++++++++
