+++++++++++++++++++
+0                +
+              ++++
+                 +
+              ++ +
+             Aa+ +
+++++++++++++++++++