++++++++
+e++++E+
+0++++b+
+ B++ad+
+ +A++ +
+   D+ +
+ ++++ +
+      +
++++++++
