+++++        +++++
+   +        +0  +
+   ++++++++++   +
+      Aa        +
+   +++++++++    +
+ B +       +b   +
+++++       ++++++
