+++++++++++++++++++
+0               B+
+              ++++
+                 +
+       +++    ++A+
+       +b      +a+
+++++++++++++++++++
