+++++++++
+B  b  B+
+ ++a++ +
+ +A A+ +
+ba 0 ab+
+ +A A+ +
+ ++a++ +
+B  b  B+
+++++++++
