++++++++
+  ab  +
+B++++A+
+  cd  +
+C++++D+
+  0   +
++++++++
