+++++++++++++++
+h            +
+g            +
+f            +
+e            +
+c           a+
+b 0ABCDEFGH d+
+++++++++++++++
