+++++++++++++
+         A +
+0         a+
+           +
+           +
+           +
+A          +
+++++++++++++
